year_index,boiler_generator_assn,utility,ownership,plants,generator_existing,generator_proposed,generator_retired
2009,0,0,0,0,0,0,0
2010,0,0,0,0,0,0,0
2011,1,1,1,1,1,1,1
2012,1,1,1,1,1,1,1
2013,1,1,1,1,1,1,1
2014,1,1,1,1,1,1,1
2015,1,1,1,1,1,1,1
2016,1,1,1,1,1,1,1
2017,1,1,1,1,1,1,1
2018,1,1,1,1,1,1,1
