year_index,generation_fuel,puerto_rico,stocks,oil_stocks,coal_stocks,petcoke_stocks,energy_storage,boiler_fuel,generator,fuel_receipts_costs,plants
2009,0,-1,1,2,3,4,-1,5,6,7,-1
2010,0,-1,1,2,3,4,-1,5,6,7,-1
2011,0,-1,1,2,3,4,-1,5,6,7,8
2012,0,-1,1,2,3,4,-1,5,6,7,8
2013,0,-1,1,2,3,4,-1,5,6,7,8
2014,0,-1,1,2,3,4,-1,5,6,7,8
2015,0,-1,1,2,3,4,-1,5,6,7,8
2016,0,-1,1,2,3,4,-1,5,6,7,8
2017,0,1,2,3,4,5,-1,6,7,8,9
2018,0,1,3,4,5,6,2,7,8,9,10
